NO ./bluestone.xpm
SO ./bluestone.xpm
WE ./bluestone.xpm
EA ./bluestone.xpm

F 220,100,0
C 225,30,0

111111111111111111111
100000000011000000001
100000000000000000001
1011000001110000N0001
111111111111111111111